0,0,0,0,0,0,0
0,0,0,0,0,0,0
0,0,0,13,0,0,0
0,0,0,0,0,0,0
0,0,0,0,0,0,0
0,0,0,0,0,0,6
0,0,0,0,0,0,6
0,0,0,0,0,0,6
0,0,0,0,0,0,0
0,1,1,1,1,1,0
0,0,1,1,1,0,0
0,0,0,1,0,0,0
0,0,0,0,0,0,0
0,0,0,0,0,0,0
0,0,0,0,0,0,0
0,0,9,0,9,0,0
0,0,0,0,0,0,0
0,9,0,9,0,9,0
0,0,0,0,0,0,0
0,0,0,3,0,0,0
0,0,0,0,0,0,6
0,0,1,0,0,0,6
0,0,0,0,1,0,6
0,0,0,0,0,0,6
0,1,0,0,1,0,6
0,0,0,0,0,0,0
0,0,0,0,0,0,0
0,1,0,0,0,4,0
0,0,0,14,0,0,0
0,0,0,0,0,0,0
0,4,0,0,0,1,0
0,0,0,0,0,0,0
0,8,0,8,0,8,0
0,0,0,0,0,0,0
0,0,1,0,1,0,0
0,0,0,0,0,0,0
1,0,0,0,0,0,6
0,1,0,0,0,0,6
0,0,1,0,0,0,6
0,0,0,1,0,0,6
0,0,0,0,1,0,6
0,0,0,0,0,1,
0,0,0,0,0,0,0
0,0,0,0,0,0,0
0,14,0,0,0,0,0
0,0,0,0,0,0,0
0,0,3,3,3,0,0
0,0,0,0,0,0,0
0,0,0,0,0,0,0
0,0,0,0,4,6,0
0,4,0,4,0,0,0
0,0,0,0,0,0,0
0,0,0,0,0,14,0
0,0,0,0,0,0,0
0,0,0,0,0,0,0
0,1,0,0,0,1,0
0,0,3,0,3,0,0
0,0,0,1,0,0,0
0,0,3,0,3,0,0
0,1,0,0,0,1,0
0,0,0,0,0,0,0
0,0,0,0,0,0,0
0,0,0,0,0,0,0
0,14,0,0,0,4,0
0,0,0,0,0,0,0
0,0,0,0,0,0,0
0,9,9,0,9,9,0
0,0,0,0,0,0,0
0,0,0,0,0,0,0
0,3,0,0,0,3,0
0,0,0,0,0,0,0
0,0,0,3,0,0,0
0,0,0,0,0,0,0
0,0,0,0,0,0,0
0,0,4,0,0,1,0
0,0,0,0,1,0,0
0,0,0,1,0,0,0
0,0,1,0,0,0,0
0,1,0,0,0,14,0
0,0,0,0,0,0,0
0,0,0,0,0,0,0
0,0,0,0,0,0,0
0,0,0,0,0,0,0
0,0,0,0,9,0,0
0,0,0,0,0,0,0
0,0,9,0,0,0,0
0,0,0,0,0,0,0
0,0,0,0,0,0,0
0,4,0,4,0,4,0
0,0,0,0,0,0,0
0,0,9,0,0,0,0
0,0,0,0,0,0,0
0,1,0,0,0,1,0
0,0,0,0,0,0,0
0,0,0,3,0,0,6
0,0,3,0,3,0,6
0,0,0,0,0,0,6
0,1,0,0,0,1,6
0,0,0,0,0,0,6
0,0,0,0,0,0,0
